70;70;4;
0:(20,20,230);
1:(0,160,0);
2:(5,100,20);
3:(220,220,220);
33333333333333333333333333333333333333333333333333333333333333333333333333333333333333333333333333333333333333333333333333333333333333333333;
33333333333333333333333333333333333333333333333333333333333333333333333333333333333333333333333333333333333333333333333333333333333333333333;
33333333333333333333333333333333333333000333333333333333333333333333333333333333333333333333333333333333333333333333333333333333333333333333;
33333333333333333333333333333333333000000000033333333333333333333333333333333333333333000000000333333333333333333333333333300000000003333333;
00033003333333333333333300000000000000000000000000000000033333000000000000000003333000000000000000000000000333333333000000000000000000000000;
00000000333333333000000000000000000000000000000000000000000000000000000000000000330000000000000000000000000003333300000000000000000000000000;
00000000003333330000000000000000000000000000000000000000000000000000000000000000000000000000000000000000000000000000000000000000000000000000;
00000000003333000000000000000000000000000000000000000000000000000000000000000000000000000000000000000000000000000000000000000000000000000000;
00000000003333000000000000000000000000211000000000000000000221111122112110000000000000000000000000000000000000000000000000000000000000000000;
00000000000000000000000000000000000002122100000000000001111111111111112211000000000000000000000000000000000000000000000000000000000000000000;
00000000000000000000000000000000000000011000000000000011211222111111100000000000000000000000000000000000000001111121111000000000000000000000;
00000000000000000000000000000000000000000000000000001111111111111111000000000000000000000000000000000000001111221112211112121000000000000000;
00000000000000000000000000000000000000000000000000001112211111211111210000000000000000000000000000000000112111112111211111110000000000000000;
00000000000000000000000000000000000000000000000000001111111111221111211100000000000000000000000000000000011111112111111111111100000000000000;
00000000000000000000000000000000000000000000000000000011111111111111110000000000000000000000000000000000000112111111111222111111110000000000;
00000000000000000011110000000000000000000000000000000001121111111100000000000000000000000000000000000000111111111111111112111122110000000000;
00000000000000111112211100000000000000000000000000000000000000000000000000000000000000211111000000000000112111222111111111111111000000000000;
00000000000011111111111111000000000000000000000000000000000000000000000000000000000001122110000000000000111111221111111111111000000000000000;
00000000000111121111111121000000000000000000000000000000000000000000000000000000000012111122100000000000001111111111111111112210000000000000;
00000000000111111121111111000000000000000000000000000000000000000000000000000000000000000000000000000000000000011112111112212222110000000000;
00000000000001211111111000000000000000000000000000000000000000000000000000000000000000000000000000000000000000012111111112100000000000000000;
00000000000000111112110000000000000000000000000000000000000000000000000000000000000000000000000000000000000000000000000000000000000000000000;
00000000000000111111000000000000000000000000000000000000000000000001211100000000000000000000000000000000000000000000000000000000000000000000;
00000000000000122110000000000000000000000000000000000000000000012111111121111110000000000000000000000000000000000000000000000000000000000000;
00000000000001221110000000000000000000000000000000000000001221112111111111111100000000000000000000000000000000000000000000000000000000000000;
00000000000001111100000000000000000000000000000000000000001111211112111122111111000000000000000000000000000000000000000000000112112100000000;
00000000000000000000000000000000000000000000000000000000000001121111111112110000000000000000000000000000000000000000000000001112211000000000;
00330000000000000000000000000000000000000000000000000000000000000000000000000000000000000000000000000000000000000000000000000000000000000000;
03330000000000000000000000033000000000000000000000000000000000000000000000000000000000000000000000000000000000000000000000000000000000000000;
03333000000000000003300333333333000000000000000000000000000000000000000000000000000000000000000000000000000000000033300000000000000000000000;
33333333333300033333333333333333333300000000000000000000000000000000000000000000000000000000000000000000000333333333333333330000000000000000;
33333333333333333333333333333333333333333333333333333333333300003333333333333333333300000000000000333333333333333333333333333333333333333333;
33333333333333333333333333333333333333333333333333333333333333333333333333333333333333333333300033333333333333333333333333333333333333333333;
33333333333333333333333333333333333333333333333333333333333333333333333333333333333333333333333333333333333333333333333333333333333333333333;
33333333333333333333333333333333333333333333333333333333333333333333333333333333333333333333333333333333333333333333333333333333333333333333;